16 10 64
1 1 1 1 1 1 1 1 1 1 1 1 1 1 1 1
1 5 2 4 5 3 5 2 2 4 1 1 1 1 1 1
1 5 2 3 1 4 4 4 4 4 1 1 1 1 1 1
1 4 2 3 4 4 1 1 1 3 1 1 1 1 1 1
1 5 1 1 1 1 1 1 2 3 1 1 1 1 1 1
1 4 1 2 1 2 2 1 2 1 1 1 1 1 1 1
1 2 2 2 1 1 2 1 1 1 1 1 1 1 1 1
1 1 1 1 2 2 1 1 1 1 1 1 1 1 1 1
1 1 1 1 1 2 2 1 1 1 1 1 2 1 1 1
1 1 1 1 1 1 1 1 1 1 1 1 1 1 1 1
